7,7,7,7,7,7,7,7,7,7,7,7,7,7,7,7,7,7,7,7,7,7,7,7,7,7,7,7,7,7,7,7,7,7,7,7,7,7,7,7,7,7,7,7,7,7,7,7,7,7,
7,0,0,0,0,0,0,0,0,0,0,0,0,0,0,0,0,0,0,0,0,0,0,0,0,0,0,0,0,7,0,0,0,0,0,0,0,0,0,0,0,0,0,0,0,0,0,0,0,7,
7,0,0,0,0,0,0,0,0,0,0,0,0,0,0,0,0,0,0,0,0,0,0,0,0,0,7,7,7,7,7,7,7,7,7,7,7,7,0,0,0,0,0,0,0,0,0,0,0,7,
7,0,0,0,0,0,0,0,0,0,0,7,7,7,0,0,0,0,0,0,0,7,7,7,7,7,0,0,0,0,0,0,0,0,7,0,0,0,7,0,0,0,0,0,0,0,0,0,0,7,
7,0,0,0,0,0,0,0,0,0,7,0,0,0,7,0,0,0,0,0,7,0,0,0,0,12,0,0,0,0,0,0,0,0,7,0,0,0,7,0,0,0,0,0,0,0,0,0,0,7,
7,0,0,0,0,0,0,0,0,7,0,0,0,0,0,7,0,0,0,0,12,0,0,0,0,7,7,7,7,7,7,7,0,0,12,0,0,0,7,0,0,0,0,0,0,0,0,0,0,7,
7,7,7,7,0,0,0,0,0,7,0,0,0,0,0,7,0,0,0,0,12,0,0,0,0,0,0,0,0,0,0,7,0,0,7,0,0,0,7,0,0,0,0,0,0,0,0,0,0,7,
7,0,0,0,7,7,0,0,0,7,0,0,0,0,0,7,0,0,0,0,7,0,0,0,0,0,0,0,0,0,0,7,0,0,7,0,0,0,7,0,0,0,0,0,0,0,0,0,0,7,
7,0,0,0,0,0,7,0,0,0,7,0,0,0,7,0,0,0,0,0,0,7,7,7,12,7,7,7,7,0,0,12,0,0,7,7,7,7,0,0,0,0,0,0,0,0,0,0,0,7,
7,7,7,0,0,0,0,7,0,0,0,7,12,7,0,0,0,0,0,0,0,7,7,0,0,0,0,0,7,0,0,7,0,0,7,0,0,0,0,0,0,0,0,0,0,0,0,0,0,7,
7,7,7,7,0,0,0,7,0,0,0,0,0,0,0,0,0,0,0,0,0,0,7,0,0,0,0,0,12,0,0,7,0,0,7,0,0,0,0,0,0,0,0,0,0,0,0,0,0,7,
4,0,0,0,0,0,0,12,0,0,0,0,0,0,0,0,0,0,0,0,0,0,7,0,0,0,0,0,7,0,0,7,0,0,7,0,0,0,0,0,0,0,0,0,0,0,0,0,0,7,
4,0,0,0,0,0,0,12,0,0,0,0,0,0,0,0,0,0,0,0,0,0,12,0,0,0,0,0,7,7,7,7,0,0,12,0,0,0,0,0,0,0,0,0,0,0,0,0,0,7,
7,7,7,7,0,10,0,7,0,0,0,0,0,0,0,0,0,0,0,0,0,0,7,0,0,0,0,0,7,0,0,7,0,0,7,0,0,0,0,0,0,0,0,0,0,0,0,0,0,7,
7,7,7,0,0,0,0,7,0,0,0,0,0,0,0,0,0,0,0,0,0,0,7,0,0,0,0,0,12,0,0,7,0,0,7,0,0,0,0,0,0,0,0,0,0,0,0,0,0,7,
7,0,0,0,0,0,7,0,0,7,7,7,7,12,12,7,0,0,0,0,0,7,7,0,0,0,0,0,7,0,0,7,0,0,7,0,0,0,0,0,0,0,0,0,0,0,0,0,0,7,
7,0,0,0,7,7,0,0,0,7,10,0,0,0,0,7,0,0,0,0,0,7,7,7,12,7,7,7,7,0,0,12,0,0,7,7,7,7,0,0,0,0,0,0,0,0,0,0,0,7,
7,7,7,7,0,0,0,0,0,7,0,0,0,0,0,7,0,0,0,0,7,0,0,0,0,0,0,0,0,0,0,7,0,0,7,0,0,0,7,0,0,0,0,0,0,0,0,0,0,7,
7,0,0,0,0,0,0,0,0,7,0,0,0,0,0,7,0,0,0,0,12,0,0,0,0,0,0,0,0,0,0,7,0,0,7,0,0,0,7,0,0,0,0,0,0,0,0,0,0,7,
7,0,0,0,0,0,0,0,0,7,0,0,0,0,0,7,0,0,0,0,12,0,0,0,0,7,7,7,7,7,7,7,0,0,12,0,0,0,7,0,0,0,0,0,0,0,0,0,0,7,
7,0,0,0,0,0,0,0,0,7,0,0,0,0,0,7,0,0,0,0,7,0,0,0,0,12,0,0,0,0,0,0,0,0,7,0,0,0,7,0,0,0,0,0,0,0,0,0,0,7,
7,0,0,0,0,0,0,0,0,7,7,7,7,7,7,7,0,0,0,0,0,7,7,7,7,7,0,0,0,0,0,0,0,0,7,0,0,0,7,0,0,0,0,0,0,0,0,0,0,7,
7,0,0,0,0,0,0,0,0,0,0,0,0,0,0,0,0,0,0,0,0,0,0,0,0,0,7,7,7,7,7,7,7,7,7,7,7,7,0,0,0,0,0,0,0,0,0,0,0,7,
7,0,0,0,0,0,0,0,0,0,0,0,0,0,0,0,0,0,0,0,0,0,0,0,0,0,0,0,0,7,0,0,0,0,0,0,0,0,0,0,0,0,0,0,0,0,0,0,0,7,
7,7,7,7,7,7,7,7,7,7,7,7,7,7,7,7,7,7,7,7,7,7,7,7,7,7,7,7,7,7,7,7,7,7,7,7,7,7,7,7,7,7,7,7,7,7,7,7,7,7,
8,8,8,8,8,8,8,8,8,8,8,8,8,8,8,8,8,8,8,8,8,8,8,8,8,8,8,8,8,8,8,8,8,8,8,8,8,8,8,8,8,8,8,8,8,8,8,8,8,7,
8,0,0,0,0,0,0,0,0,0,0,0,0,0,0,0,0,0,0,0,0,0,0,0,0,0,0,0,0,0,0,0,0,0,0,0,0,0,0,0,0,0,0,0,0,0,0,0,0,7,
8,0,0,0,0,0,0,0,0,0,0,0,0,0,0,0,0,0,0,0,0,0,0,0,0,0,0,0,0,0,0,0,0,0,0,0,0,0,0,0,8,8,8,8,8,8,8,0,0,7,
8,0,0,0,0,0,0,0,0,0,0,8,8,8,0,0,0,0,0,0,0,8,8,8,8,8,8,8,8,8,8,8,0,0,0,0,0,0,8,8,0,0,0,0,0,0,0,8,0,7,
8,0,0,0,0,0,0,0,0,0,8,0,0,0,8,0,0,0,0,0,8,0,0,0,0,0,0,9,0,0,0,0,8,8,8,8,8,8,8,0,0,0,0,0,0,0,0,8,0,7,
8,0,0,0,0,0,0,0,0,8,0,0,0,0,0,8,0,0,0,0,8,0,0,0,0,0,0,8,8,8,8,0,0,0,0,0,0,0,8,0,0,0,0,0,0,0,0,8,0,7,
8,0,0,0,0,0,0,0,0,8,0,0,0,0,0,8,0,0,0,0,8,0,0,0,0,0,0,8,0,0,0,8,0,0,8,8,8,8,0,0,0,0,0,0,0,0,0,8,0,7,
8,0,0,0,0,0,0,0,0,8,0,0,0,0,0,8,0,0,0,0,8,0,0,0,0,0,0,8,0,0,8,0,8,0,0,8,0,0,0,0,0,0,0,0,0,0,0,8,0,7,
8,0,0,0,0,0,0,0,0,0,8,0,0,0,8,0,0,0,0,0,0,8,8,8,9,8,8,0,0,8,0,0,9,0,0,0,0,0,0,0,0,0,0,0,0,0,0,8,0,7,
8,0,0,0,0,0,0,0,0,0,8,0,0,0,8,0,0,0,0,0,0,0,0,8,0,0,0,8,8,8,0,0,8,0,0,0,0,0,0,0,0,0,0,0,0,0,0,8,0,7,
8,0,0,0,0,0,0,0,8,8,0,0,0,0,0,8,8,0,0,0,0,0,0,8,0,0,0,0,0,9,0,0,8,0,0,0,0,0,0,0,0,0,0,0,0,0,0,8,0,7,
8,0,0,0,0,0,0,8,0,0,0,0,0,0,0,0,0,8,8,8,8,8,8,0,0,0,0,0,0,8,0,0,8,0,0,0,0,0,0,0,0,0,0,0,0,0,0,8,0,7,
8,0,0,0,0,0,0,8,0,0,0,0,0,0,0,0,0,9,0,0,0,0,9,0,0,0,0,0,0,8,8,8,8,0,0,0,0,0,0,0,0,0,0,0,0,0,0,8,0,7,
8,0,0,0,0,0,0,8,0,0,0,0,0,0,0,0,0,8,8,8,8,8,8,0,0,0,0,0,0,8,0,0,8,0,0,0,0,0,0,0,0,0,0,0,0,0,0,8,0,7,
8,0,0,0,0,0,0,0,8,8,0,0,0,0,0,8,8,0,0,0,0,0,0,8,0,0,0,0,0,9,0,0,8,0,0,0,0,0,0,0,0,0,0,0,0,0,0,8,0,7,
8,0,0,0,0,0,0,0,0,8,0,0,0,0,0,8,0,0,0,0,0,0,0,8,0,0,0,8,8,8,0,0,8,0,0,0,0,0,0,0,0,0,0,0,0,0,0,8,0,7,
8,0,0,0,0,0,0,0,0,8,0,0,0,0,0,8,0,0,0,0,0,8,8,8,9,8,8,0,0,8,0,0,9,0,0,0,0,0,0,0,0,0,0,0,0,0,0,8,0,7,
7,0,0,0,0,0,0,0,0,8,0,0,0,0,0,8,0,0,0,0,8,0,0,0,0,0,0,8,0,0,8,0,8,0,0,8,0,0,0,0,0,0,0,0,0,0,0,8,0,7,
7,0,0,0,0,0,0,0,0,8,0,0,0,0,0,8,0,0,0,0,8,0,0,0,0,0,0,8,0,0,0,8,0,0,8,8,8,8,0,0,0,0,0,0,0,0,0,8,0,7,
7,0,0,0,0,0,0,0,0,8,0,0,0,0,0,8,0,0,0,0,8,0,0,0,0,0,0,8,8,8,8,0,0,0,0,0,0,0,8,0,0,0,0,0,0,0,0,8,0,7,
7,0,0,0,0,0,0,0,0,8,0,0,0,0,0,8,0,0,0,0,8,0,0,0,0,0,0,9,0,0,0,0,8,8,8,8,8,8,8,0,0,0,0,0,0,0,0,8,0,7,
7,0,0,0,0,0,0,0,0,8,8,8,8,8,8,8,0,0,0,0,0,8,8,8,8,8,8,8,8,8,8,8,0,0,0,0,0,0,8,8,0,0,0,0,0,0,0,8,0,7,
7,0,0,0,0,0,0,0,0,0,0,0,0,0,0,0,0,0,0,0,0,0,0,0,0,0,0,0,0,0,0,0,0,0,0,0,0,0,0,0,8,8,8,8,8,8,8,0,0,7,
7,0,0,0,0,0,0,0,0,0,0,0,0,0,0,0,0,0,0,0,0,0,0,0,0,0,0,0,0,0,0,0,0,0,0,0,0,0,0,0,0,0,0,0,0,0,0,0,0,7,
7,7,7,7,7,7,7,7,7,7,7,7,7,7,7,7,7,7,7,7,7,7,7,7,7,7,7,7,7,7,7,7,7,7,7,7,7,7,7,7,7,7,7,7,7,7,7,7,7,7,
