2,2,4,4,2,2,2,2,2,2,2,2,2,2,2,2,2,2,2,2,2,2,2,2,2,
2,0,0,0,0,2,0,0,2,2,0,0,0,0,0,0,0,0,2,0,0,0,0,0,2,
2,0,0,0,0,2,0,0,2,2,0,0,0,0,0,0,0,0,2,0,0,0,0,0,2,
2,0,0,0,0,9,0,0,2,2,0,0,0,0,0,0,0,0,2,0,0,0,0,0,2,
2,0,0,0,0,2,0,0,2,2,0,0,0,0,0,0,0,0,2,0,0,0,0,0,2,
2,0,0,0,0,10,0,0,2,2,0,0,0,0,0,0,0,0,9,0,0,0,0,0,2,
2,2,2,2,2,2,0,0,2,2,0,0,0,0,0,0,0,0,2,0,0,0,0,0,2,
2,0,0,0,0,0,0,0,2,2,0,0,0,0,0,0,0,0,2,0,0,0,0,0,2,
2,0,0,0,0,0,0,0,2,2,0,0,0,0,0,0,0,0,2,0,0,0,0,0,2,
2,0,0,0,0,0,0,0,2,2,0,0,0,0,0,0,0,0,2,0,0,0,0,0,2,
2,0,0,0,0,0,0,0,2,2,0,0,0,0,0,0,0,0,2,0,0,0,0,0,2,
2,0,0,0,0,0,0,0,2,2,0,0,0,0,0,0,0,2,0,0,0,0,0,0,2,
2,0,0,0,0,0,0,0,2,2,0,0,0,0,0,0,2,0,0,0,0,0,0,0,2,
2,0,0,0,0,0,0,0,10,2,2,2,2,2,2,2,0,0,0,0,0,0,0,0,2,
2,2,2,5,5,5,2,2,2,2,0,0,0,0,0,0,5,0,0,0,0,0,0,0,2,
2,0,2,0,0,0,0,0,0,2,0,0,0,0,0,0,0,5,0,0,0,2,5,5,2,
2,0,2,0,0,0,0,0,0,0,2,0,0,0,0,0,0,0,5,0,10,0,0,0,2,
2,2,0,0,0,0,0,0,0,0,2,0,0,0,0,0,0,0,0,2,0,0,0,0,2,
2,0,0,0,2,10,2,0,0,2,0,2,0,0,0,0,0,0,0,2,0,0,0,0,2,
2,0,0,0,10,2,10,0,0,2,0,9,0,0,0,0,0,0,0,2,0,0,0,0,2,
2,0,0,0,2,10,2,0,0,2,0,2,0,0,0,0,0,0,0,2,0,0,0,0,2,
2,2,0,0,0,0,0,0,0,0,2,0,0,0,0,0,0,0,0,2,0,0,0,0,2,
2,0,2,0,0,0,0,0,0,0,2,0,0,0,0,0,0,0,0,2,0,0,0,0,2,
2,0,2,0,0,0,0,0,0,2,0,0,0,0,0,0,0,0,10,2,0,0,0,0,2,
2,2,2,2,2,2,2,2,2,2,2,2,2,2,2,2,2,2,2,2,2,4,4,2,2,
