2,2,10,2,2,2,2,2,2,2,2,2,2,2,2,2,2,2,2,2,
2,0,0,0,2,0,0,0,2,0,0,2,0,0,0,0,0,0,0,2,
2,0,0,0,2,0,10,0,2,0,0,2,0,0,0,0,0,0,0,2,
2,0,0,0,2,0,0,0,2,0,0,2,0,0,0,0,0,0,0,2,
2,2,9,2,2,2,9,2,2,2,0,2,0,0,0,0,0,0,0,2,
2,0,0,0,2,0,0,0,2,0,0,2,0,0,0,0,0,0,0,2,
10,0,0,0,9,0,0,0,2,0,0,2,0,0,0,0,0,0,0,2,
2,0,0,0,2,0,0,0,2,0,2,2,0,0,0,0,0,0,0,2,
2,2,9,2,2,2,9,2,2,0,0,2,2,2,2,9,2,2,2,2,
2,0,0,0,2,0,0,0,2,0,0,2,0,0,0,0,0,0,0,2,
2,0,10,0,2,0,10,0,2,2,0,2,0,0,0,0,0,0,0,2,
2,0,0,0,2,0,0,0,2,0,0,2,0,0,0,0,0,0,0,2,
2,2,2,2,2,2,9,2,2,0,0,2,2,2,2,2,2,9,2,2,
2,0,0,0,2,0,0,0,2,0,2,2,0,0,0,2,0,0,0,2,
2,0,0,0,9,0,10,0,2,0,0,2,0,10,0,9,0,0,0,2,
2,0,0,0,2,0,0,0,2,0,0,2,0,0,0,2,0,0,0,2,
2,2,9,2,2,2,2,2,2,10,9,2,2,9,2,2,2,9,2,2,
2,0,0,0,0,0,0,0,2,0,0,2,0,0,0,0,0,0,0,2,
2,0,0,0,0,0,0,0,2,4,4,2,0,0,0,10,0,0,0,2,
2,2,2,2,2,2,2,2,2,2,2,2,2,2,2,2,2,2,2,2,
