9,7,5,7,0,
7,4,0,4,4,
6,3,1,3,4,
5,4,2,4,4,
7,9,7,9,3,
0,3,0,3,3,
0,4,0,4,3,
