2,2,2,2,2,2,2,2,2,2,2,2,2,2,2,
2,0,0,0,0,0,0,0,2,0,0,0,0,0,2,
2,0,0,0,0,0,0,0,3,0,0,0,0,0,2,
4,0,0,0,0,0,0,0,0,0,0,0,0,0,2,
4,0,0,0,0,0,0,0,2,0,0,0,0,0,2,
2,0,0,0,0,2,2,3,2,2,0,0,0,0,2,
2,0,2,2,2,2,0,0,0,2,0,0,0,0,2,
2,2,3,0,0,9,0,0,0,10,2,0,0,0,2,
2,0,2,0,2,2,0,0,0,2,2,0,3,2,2,
2,0,0,0,0,2,2,4,2,2,0,0,0,0,2,
2,0,0,0,0,0,0,2,0,0,0,0,0,0,2,
2,0,0,0,0,0,0,0,0,0,0,0,0,0,2,
2,0,0,0,0,0,0,3,0,0,0,0,0,0,2,
2,0,0,0,0,0,0,2,0,0,0,0,0,0,2,
2,2,2,2,2,2,2,2,2,2,2,2,2,2,2,
